111111
1000E1
100000001
1C0001
1P0001
111111
